11111111111111111111111111111111111111111111111111
1E0000000000000C00000C00C00000C00C00000C0000000001
10100101001000001010010001010010001010010000000001
10100100101010100010010100010010100010010000000001
10100101001000001010010001010010001010010000000001
10100100101010100010010100010010100010010000000001
10100101001000001010010001010010001010010000000001
10100100101010100010010100010010100010010000000001
100000000C00C0000000000000000000000000000000000001
100P00000C00C0000000000000000000000000000000000001
1E0000000000000C00000C00C00000C00C00000C0000000001
11111111111111111111111111111111111111111111111111