11111111111111111
00000000000000000
55555555555555555
77777777777777777
dodododododododoo
mmamamammamamamam
11111111111111111