1111111111111
10010000000C1
10000eeeee001
1000010000001
1111111111111