1111111111111
10010000000C1
1000011111001
1P00S1ECCCCC1
1111111111111